40
///////////////
///////////////
///////////////
///////////////
/////#####/////
/////#@@@###///
/////#@!@@@#///
/////##@?@@#///
/////####?##///
/////#@@?@##///
/////#@$@@@#///
/////###!@!#///
///////#####///
///////////////
///////////////


