79
///////////////
///////////////
///////////////
///////////////
///####//####//
///#@@####@+#//
///#@@@@@@@@#//
///#@@####@@#//
///##$##!@?##//
///#@@#!?!@#///
///#@@@?@@##///
///#@@#@@##////
///#######/////
///////////////
///////////////
