30
///////////////
///////////////
///////////////
///////////////
/////#####/////
/////#@@@###///
/////#@@@@@#///
/////##@@@@#///
/////####?##///
/////#@@?@##///
/////#@$@@@#///
/////###!@!#///
///////#####///
///////////////
///////////////
