32
//////////
////##@#//
#####@@#//
#@@@?@@#//
#@!!#@@#//
##@##@##//
#@@@@?@#//
#@$#@@@#//
#@@#####//
####//////
