21
///////////////
///////////////
///////////////
///////////////
////#####//////
////#@@@#//////
///##?#@###////
///#@@@?$@#////
///#@#@@#@#////
///#@#!@!@#////
///#@@@####////
///#####///////
///////////////
///////////////
///////////////
