43
///////////////
///////////////
///////////////
///////////////
////####///////
////#@@####////
////#@@@@@#////
////#@@@@@#////
////###@###////
////#@???@##///
////#@!!!$@#///
////####@@@#///
///////#####///
