21
//////////
//##@##///
//#@@@#///
/##?#@###/
/#@@@?$@#/
/#@#@@#@#/
/#@#!@!@#/
/#@@@####/
/#####////
//////////

