37
///////////////
///////////////
///////////////
///////////////
/////######////
/////#x@$@##///
////##@#@@@#///
////#@!@!@!#///
////#@@?@?@#///
////#####?@#///
////////#@@#///
////////####///
///////////////
///////////////
///////////////

