79
//////////
#/##//####
#@@####@+#
#@@@@@@@@#
#@@##?@@@#
##$#@!@@##
#@@@!?!@#/
#@@@?@@##/
#@@#@@##//
#######///

