43
//////////
//#@##////
//#@@####/
//#@@@@@#/
//#@@@@@#/
//###@###/
//#@???@##
//#@!!!$@#
//####@@@#
/////#####