37
///////////
///#/#@##//
///#x@@@##/
//##@#@@@#/
//#@!@!@!#/
//#@@?@?@#/
//#####?@#/
//////#@@#/
//////####/
///////////


