30
//////////
//##@##///
//#@@@###/
//#@@@@@#/
//##@@@@#/
//####?##/
//#@@?@##/
//#@$@@@#/
//###!@!#/
////#####/

