40
//////////
//##@##///
//#@@@###/
//#@!@@@#/
//##@?@@#/
//####?##/
//#@@?@##/
//#@$@@@#/
//###!@!#/
////#####/



