32
///////////////
///////////////
///////////////
///////////////
///////####////
///#####@@#////
///#@@@?@@#////
///#@!!#@@#////
///##@##@##////
///#@@@@?@#////
///#@$#@@@#////
///#@@#####////
///####////////
///////////////
///////////////
